1111111111111
1P00000000001
1000011111001
1000010000001
1111010111101
1C00000C000E1
1111111111111
